{
	"map": {
		"data": [
			[ 604, 599, 599, 599, 599, 599, 599, 599, 599, 599, 599, 599, 599, 599, 599, 599, 599, 599, 599, 605 ],
			[ 602, 658, 658, 658, 658, 658, 658, 658, 658, 658, 658, 658, 658, 658, 658, 658, 658, 658, 658, 602 ],
			[ 602, 658, 658, 658, 658, 658, 658, 658, 658, 658, 658, 658, 658, 658, 658, 658, 658, 658, 658, 602 ],
			[ 602, 658, 658, 658, 658, 658, 658, 658, 658, 658, 658, 658, 658, 658, 658, 658, 658, 658, 658, 602 ],
			[ 602, 658, 658, 658, 658, 658, 658, 658, 658, 658, 658, 658, 658, 658, 658, 658, 658, 658, 658, 602 ],
			[ 602, 658, 658, 658, 658, 658, 658, 658, 658, 658, 658, 658, 658, 658, 658, 658, 658, 658, 658, 602 ],
			[ 602, 658, 658, 658, 658, 658, 658, 658, 658, 658, 658, 658, 658, 658, 658, 658, 658, 658, 658, 602 ],
			[ 602, 658, 658, 658, 658, 658, 658, 658, 658, 658, 658, 658, 658, 658, 658, 658, 658, 658, 658, 602 ],
			[ 602, 658, 1199, 1199, 1199, 1199, 658, 658, 658, 658, 658, 658, 658, 658, 658, 658, 658, 658, 658, 602 ],
			[ 602, 1199, 1199, 1199, 1199, 1199, 1199, 658, 658, 658, 658, 658, 658, 658, 658, 658, 658, 658, 658, 602 ],
			[ 602, 1199, 1199, 1199, 1199, 1199, 1199, 658, 658, 658, 658, 658, 658, 658, 658, 658, 658, 658, 658, 602 ],
			[ 602, 1199, 1199, 1199, 1199, 1199, 1199, 658, 658, 658, 658, 658, 658, 658, 658, 658, 658, 658, 658, 602 ],
			[ 602, 1199, 1199, 1199, 1199, 1199, 1199, 658, 658, 658, 658, 658, 658, 658, 658, 658, 658, 658, 658, 602 ],
			[ 602, 658, 1199, 1199, 1199, 1199, 658, 658, 658, 658, 658, 658, 658, 658, 658, 658, 658, 658, 658, 602 ],
			[ 606, 599, 599, 599, 599, 599, 599, 599, 599, 599, 599, 599, 599, 599, 599, 605, 1199, 604, 599, 607 ],

			[ -1, -1, -1, -1, -1, -1, -1, -1, -1, -1, -1, -1, -1, -1, -1, -1, -1, -1, -1, -1 ],
			[ -1, -1, -1, -1, -1, -1, -1, -1, -1, -1, -1, -1, -1, -1, -1, -1, -1, -1, -1, -1 ],
			[ -1, -1, -1, -1, -1, -1, -1, -1, -1, -1, -1, -1, -1, -1, -1, -1, -1, -1, -1, -1 ],
			[ -1, -1, -1, -1, -1, -1, -1, -1, -1, -1, -1, -1, -1, -1, -1, -1, -1, -1, -1, -1 ],
			[ -1, -1, -1, -1, -1, -1, -1, -1, -1, -1, -1, -1, -1, -1, -1, -1, -1, -1, -1, -1 ],
			[ -1, -1, -1, -1, -1, -1, -1, -1, -1, -1, -1, -1, -1, -1, -1, -1, -1, -1, -1, -1 ],
			[ -1, -1, -1, -1, -1, -1, -1, -1, -1, -1, -1, -1, -1, -1, -1, -1, -1, -1, -1, -1 ],
			[ -1, -1, -1, -1, -1, -1, -1, -1, -1, -1, -1, -1, -1, -1, -1, -1, -1, -1, -1, -1 ],
			[ -1, 658, 662, 662, 662, 662, -1, -1, -1, -1, -1, -1, -1, -1, -1, -1, -1, -1, -1, -1 ],
			[ -1, 661, -1, -1, -1, -1, 663, -1, -1, -1, -1, -1, -1, -1, -1, -1, -1, -1, -1, -1 ],
			[ -1, 661, -1, 665, 664, -1, 663, -1, -1, -1, -1, -1, -1, -1, -1, -1, -1, -1, -1, -1 ],
			[ -1, 661, -1, 666, 667, -1, 663, -1, -1, -1, -1, -1, -1, -1, -1, -1, -1, -1, -1, -1 ],
			[ -1, 661, -1, -1, -1, -1, 663, -1, -1, -1, -1, -1, -1, -1, -1, -1, -1, -1, -1, -1 ],
			[ -1, 658, 660, 660, 660, 660, -1, -1, -1, -1, -1, -1, -1, -1, -1, -1, -1, -1, -1, -1 ],
			[ -1, -1, -1, -1, -1, -1, -1, -1, -1, -1, -1, -1, -1, -1, -1, -1, -1, -1, -1, -1 ],

			[ 16, 11, 11, 11, 11, 11, 11, 11, 11, 11, 11, 11, 11, 11, 11, 19, 47, 18, 11, 17 ],
			[ 14, 47, 47, 47, 47, 47, 47, 47, 47, 47, 47, 47, 47, 47, 47, 47, 47, 47, 47, 14 ],
			[ 14, 47, 47, 47, 47, 47, 47, 47, 47, 47, 47, 47, 47, 47, 47, 47, 47, 47, 47, 14 ],
			[ 14, 47, 47, 47, 47, 47, 47, 47, 47, 47, 47, 47, 47, 47, 47, 47, 47, 47, 47, 14 ],
			[ 14, 47, 47, 47, 47, 47, 47, 47, 47, 47, 47, 47, 47, 47, 47, 47, 47, 47, 47, 14 ],
			[ 14, 47, 47, 47, 47, 47, 47, 47, 47, 47, 47, 47, 47, 47, 47, 47, 47, 47, 47, 14 ],
			[ 14, 47, 47, 47, 47, 47, 47, 47, 47, 47, 47, 47, 47, 47, 47, 47, 47, 47, 47, 14 ],
			[ 14, 47, 47, 47, 47, 47, 47, 47, 47, 47, 47, 47, 47, 47, 47, 47, 47, 47, 47, 14 ],
			[ 14, 47, 47, 47, 47, 47, 47, 47, 47, 47, 47, 47, 47, 47, 47, 47, 47, 47, 47, 14 ],
			[ 14, 47, 47, 47, 47, 47, 47, 47, 47, 47, 47, 47, 47, 47, 47, 47, 47, 47, 47, 14 ],
			[ 14, 47, 47, 47, 47, 47, 47, 47, 47, 47, 47, 47, 47, 47, 47, 47, 47, 47, 47, 14 ],
			[ 14, 47, 47, 47, 47, 47, 47, 47, 47, 47, 47, 47, 47, 47, 47, 47, 47, 47, 47, 14 ],
			[ 14, 47, 47, 47, 47, 47, 47, 47, 47, 47, 47, 47, 47, 47, 47, 47, 47, 47, 47, 14 ],
			[ 14, 47, 47, 47, 47, 47, 47, 47, 47, 47, 47, 47, 47, 47, 47, 47, 47, 47, 47, 14 ],
			[ 18, 11, 11, 11, 11, 11, 11, 11, 11, 11, 11, 11, 11, 11, 11, 11, 11, 11, 11, 19 ],

			[ -1, -1, -1, -1, -1, -1, -1, -1, -1, -1, -1, -1, -1, -1, -1, -1, -1, -1, -1, -1, -1 ],
			[ -1, -1, -1, -1, -1, -1, -1, -1, -1, -1, -1, -1, -1, -1, -1, -1, -1, -1, -1, -1, -1 ],
			[ -1, -1, -1, -1, -1, -1, -1, -1, -1, -1, -1, -1, -1, -1, -1, -1, -1, -1, -1, -1, -1 ],
			[ -1, -1, -1, -1, -1, -1, -1, -1, -1, -1, -1, -1, -1, -1, -1, -1, -1, -1, -1, -1, -1 ],
			[ -1, -1, -1, -1, -1, -1, -1, -1, -1, -1, -1, -1, -1, -1, -1, -1, -1, -1, -1, -1, -1 ],
			[ -1, -1, -1, -1, -1, -1, -1, -1, -1, -1, -1, -1, -1, -1, -1, -1, -1, -1, -1, -1, -1 ],
			[ -1, -1, -1, -1, -1, -1, -1, -1, -1, -1, -1, -1, -1, -1, -1, -1, -1, -1, -1, -1, -1 ],
			[ -1, -1, -1, -1, -1, -1, -1, -1, -1, -1, -1, -1, -1, -1, -1, -1, -1, -1, -1, -1, -1 ],
			[ -1, -1, -1, -1, -1, -1, -1, -1, -1, -1, -1, -1, -1, -1, -1, -1, -1, -1, -1, -1, -1 ],
			[ -1, -1, -1, -1, -1, -1, -1, -1, -1, -1, -1, -1, -1, -1, -1, -1, -1, -1, -1, -1, -1 ],
			[ -1, -1, -1, -1, -1, -1, -1, -1, -1, -1, -1, -1, -1, -1, -1, -1, -1, -1, -1, -1, -1 ],
			[ -1, -1, -1, -1, -1, -1, -1, -1, -1, -1, -1, -1, -1, -1, -1, -1, -1, -1, -1, -1, -1 ],
			[ -1, -1, -1, -1, -1, -1, -1, -1, -1, -1, -1, -1, -1, -1, -1, -1, -1, -1, -1, -1, -1 ],
			[ -1, -1, -1, -1, -1, -1, -1, -1, -1, -1, -1, -1, -1, -1, -1, -1, -1, -1, -1, -1, -1 ],
			[ -1, -1, -1, -1, -1, -1, -1, -1, -1, -1, -1, -1, -1, -1, -1, -1, -1, -1, -1, -1, -1 ]
		],

		"walkability": [
			true,
			true,
			true,
			true,
			true,
			true,
			true,
			true,
			true,
			true,
			true,
			false,
			false,
			false,
			false,
			false,
			false,
			false,
			false,
			false,
			true,
			true,
			true,
			true,
			true,
			true,
			true,
			true,
			true,
			true,
			true,
			true,
			true,
			true,
			true,
			true,
			true,
			true,
			true,
			true,
			true,
			true,
			true,
			true,
			true,
			true,
			true,
			true
		],

		"layerCount": 2,

		"width": 1,
		"height": 2,
		"roomWidth": 20,
		"roomHeight": 15,
		"currentRoom": {
			"x": 0,
			"y": 0
		},

		"player": {
			"startingPosition": {
				"x": 1,
				"y": 1
			},
			"startingRoom": {
				"x": 0,
				"y": 0
			}
		}
	}
}
